Nitwits - придурки
Layoffs - увольнения
Auspicious - благоприятный
Vicissitudes - misfortunes, unwelcome changes
Inclement - суровый, холодный
Frantic - безумный
Repercussions - последствия
Shun - избегать
It surges year after year - это увеличивается от года в год 
Conspicuous - бросающийся в глаза
Jerry can - канистра (солярка)
Blackmailing - шантажировать
He adheres to it - он придерживается этому
Curb - сдерживать / бордюр
Leaflets - листовки
Tenacity - упорство
Innate - врождённый, природный
Hands-on experience - практический опыт
Vigorous - энергичный, сильный
Explicit - явный
Daredevils - смельчаки
Intricate - запутанный, сложный
Ingenuity - изобретательность
Briefcase - портфель типа case
Accomplice - сообщник
Acclaim - признание
Persistence - настойчивость
Haulage - перевозка / буксировка
Log - журнал / брусок
de-track - 
Wherein he lives - в котором он живёт
Detention - задержание под стражу
Obscure - неясный
Cord - шнур, струна, верёвка
Amenities - удобства
Impoverished - обедневший
Appertain / Pertaining - 
Forerunner - предшественник
Beverage - drink - напиток
Reputed - известный / предполагаемый
Became aware - стало известно
Eminent - выдающийся
Perseverance - persistence - настойчивость, упорство
Atrocity - злодеяние, зверство
Deliberately - сознательно
To curry a favour - выслуживаться
Preference - предпочтение
Misused - неправильно использованный
They will be willing - они будут готовы
Clues - подсказки
